//MAP CONVERTED BY dmm2tgm.py THIS HEADER COMMENT PREVENTS RECONVERSION, DO NOT REMOVE
"ah" = (
/obj/effect/glowshroom,
/turf/open/mars_cave/mars_cave_10,
/area/bigredv2/caves_lambda)
"ai" = (
/obj/effect/landmark/structure_spawner/setup/distress/xeno_weed_node,
/turf/open/mars_cave/mars_cave_11,
/area/bigredv2/caves_lambda)
"ak" = (
/obj/effect/glowshroom,
/turf/open/mars_cave,
/area/bigredv2/caves_lambda)
"al" = (
/obj/effect/glowshroom,
/turf/open/mars_cave/mars_cave_7,
/area/bigredv2/caves_lambda)
"ao" = (
/obj/structure/machinery/light,
/turf/open/floor/darkpurplecorners2/east,
/area/bigredv2/caves/lambda/breakroom)
"ap" = (
/obj/structure/sign/safety/bulkhead_door,
/turf/closed/wall/solaris/reinforced,
/area/bigredv2/caves/lambda/breakroom)
"as" = (
/obj/structure/machinery/door/poddoor/almayer{
	id = "sci_br";
	name = "\improper Lambda Observation Shutters"
	},
/obj/item/shard,
/obj/structure/window_frame/solaris/reinforced,
/turf/open/floor/plating,
/area/bigredv2/caves/lambda/breakroom)
"au" = (
/turf/open/floor/strata/white_cyan1/east,
/area/bigredv2/caves/lambda/breakroom)
"av" = (
/obj/structure/filingcabinet{
	density = 0;
	pixel_x = 8;
	pixel_y = 20
	},
/obj/structure/filingcabinet{
	density = 0;
	pixel_x = -8;
	pixel_y = 16
	},
/turf/open/floor/strata/white_cyan1/east,
/area/bigredv2/caves/lambda/breakroom)
"aw" = (
/obj/structure/inflatable/popped/door,
/turf/open/floor/darkpurplecorners2,
/area/bigredv2/caves/lambda/breakroom)
"ax" = (
/obj/structure/barricade/wooden{
	dir = 1;
	pixel_y = 7
	},
/turf/open/floor/darkpurplecorners2,
/area/bigredv2/caves/lambda/breakroom)
"ay" = (
/turf/open/mars_cave/mars_cave_8,
/area/bigredv2/caves_lambda)
"az" = (
/turf/open/mars_cave/mars_cave_5,
/area/bigredv2/caves_lambda)
"aB" = (
/turf/open/floor/almayer/w_y0/north,
/area/bigredv2/caves/lambda/breakroom)
"aD" = (
/obj/structure/inflatable/popped/door,
/turf/open/floor/darkpurplecorners2/east,
/area/bigredv2/caves/lambda/breakroom)
"aE" = (
/turf/open/floor/darkpurplecorners2/east,
/area/bigredv2/caves/lambda/breakroom)
"aG" = (
/obj/structure/window/framed/solaris/reinforced,
/obj/structure/machinery/door/poddoor/almayer{
	id = "sci_br";
	name = "\improper Lambda Observation Shutters"
	},
/turf/open/floor/plating,
/area/bigredv2/caves/lambda/breakroom)
"aJ" = (
/obj/structure/machinery/door/poddoor/almayer{
	id = "sci_br";
	name = "\improper Lambda Observation Shutters"
	},
/obj/item/shard{
	icon_state = "medium"
	},
/obj/structure/window_frame/solaris/reinforced,
/turf/open/floor/plating,
/area/bigredv2/caves/lambda/breakroom)
"aK" = (
/obj/structure/surface/table/reinforced/prison,
/obj/structure/machinery/door_control{
	id = "vault";
	name = "Vault Lockdown"
	},
/turf/open/floor/strata/white_cyan1/east,
/area/bigredv2/caves/lambda/breakroom)
"aL" = (
/obj/structure/surface/table/reinforced/prison,
/obj/item/spacecash/c1000,
/obj/item/spacecash/c1000,
/obj/item/spacecash/c1000,
/obj/item/spacecash/c1000,
/turf/open/floor/strata/white_cyan1/east,
/area/bigredv2/caves/lambda/breakroom)
"aM" = (
/turf/template_noop,
/area/template_noop)
"aN" = (
/turf/open/mars_cave,
/area/bigredv2/caves_lambda)
"aP" = (
/turf/open/mars_cave/mars_cave_10,
/area/bigredv2/caves_lambda)
"aQ" = (
/turf/open/mars_cave/mars_cave_7,
/area/bigredv2/caves_lambda)
"aS" = (
/obj/effect/glowshroom,
/turf/open/mars_cave/mars_cave_2,
/area/bigredv2/caves_lambda)
"aT" = (
/turf/open/mars_cave/mars_cave_2,
/area/bigredv2/caves_lambda)
"aV" = (
/obj/effect/landmark/structure_spawner/setup/distress/xeno_weed_node,
/turf/open/mars_cave/mars_cave_2,
/area/bigredv2/caves_lambda)
"aX" = (
/turf/closed/wall/solaris/rock,
/area/bigredv2/caves)
"bb" = (
/turf/open/mars_cave/mars_cave_4,
/area/bigredv2/caves_lambda)
"bc" = (
/turf/open/mars_cave/mars_cave_6,
/area/bigredv2/caves_lambda)
"bd" = (
/obj/item/tool/pickaxe/drill,
/obj/effect/landmark/structure_spawner/setup/distress/xeno_weed_node,
/turf/open/mars_cave/mars_cave_2,
/area/bigredv2/caves_lambda)
"be" = (
/turf/open/mars_cave/mars_cave_18,
/area/bigredv2/caves_lambda)
"bf" = (
/obj/item/shard{
	icon_state = "medium"
	},
/turf/open/mars_cave/mars_cave_6,
/area/bigredv2/caves_lambda)
"bg" = (
/obj/effect/decal/cleanable/blood/xeno,
/turf/open/mars_cave/mars_cave_7,
/area/bigredv2/caves_lambda)
"bh" = (
/obj/item/shard{
	icon_state = "small"
	},
/turf/open/mars_cave/mars_cave_18,
/area/bigredv2/caves_lambda)
"bi" = (
/turf/closed/wall/solaris/reinforced,
/area/bigredv2/caves/lambda/breakroom)
"bj" = (
/obj/structure/machinery/light,
/turf/open/floor/strata/white_cyan1/east,
/area/bigredv2/caves/lambda/breakroom)
"bk" = (
/obj/structure/sign/safety/restrictedarea{
	pixel_x = 8;
	pixel_y = -32
	},
/obj/effect/landmark/structure_spawner/setup/distress/xeno_weed_node,
/turf/open/floor/darkpurplecorners2/east,
/area/bigredv2/caves/lambda/breakroom)
"bl" = (
/obj/structure/barricade/wooden,
/turf/open/floor/darkpurplecorners2/east,
/area/bigredv2/caves/lambda/breakroom)
"bm" = (
/obj/effect/decal/cleanable/blood/drip{
	pixel_y = 6
	},
/turf/open/floor/darkpurplecorners2/east,
/area/bigredv2/caves/lambda/breakroom)
"bn" = (
/obj/structure/machinery/door/airlock/almayer/secure/reinforced/colony{
	icon_state = "door_locked"
	},
/obj/structure/machinery/door/poddoor/almayer/closed{
	dir = 4;
	id = "vault";
	name = "Vault Lockdown"
	},
/turf/open/floor/delivery,
/area/bigredv2/caves/lambda/breakroom)
"bo" = (
/turf/open/floor/plating/almayer,
/area/bigredv2/caves/lambda/breakroom)
"bp" = (
/obj/structure/machinery/door_control{
	id = "sci_br";
	name = "Observation Shutters";
	pixel_y = 28
	},
/obj/effect/decal/cleanable/blood/gibs/xeno,
/turf/open/floor/darkpurplecorners2,
/area/bigredv2/caves/lambda/breakroom)
"bq" = (
/obj/structure/machinery/light{
	dir = 1
	},
/obj/effect/decal/cleanable/blood,
/turf/open/floor/darkpurplecorners2,
/area/bigredv2/caves/lambda/breakroom)
"br" = (
/obj/effect/decal/cleanable/blood/drip{
	pixel_x = -8;
	pixel_y = 6
	},
/turf/open/floor/darkpurplecorners2,
/area/bigredv2/caves/lambda/breakroom)
"bs" = (
/obj/structure/inflatable/popped/door,
/obj/effect/decal/cleanable/blood/drip{
	pixel_x = -11;
	pixel_y = 10
	},
/turf/open/floor/darkpurplecorners2,
/area/bigredv2/caves/lambda/breakroom)
"bt" = (
/obj/effect/decal/cleanable/mucus,
/obj/structure/machinery/door_control{
	id = "sci_br";
	name = "Observation Shutters";
	pixel_y = 28
	},
/obj/effect/decal/cleanable/vomit,
/turf/open/floor/darkpurplecorners2,
/area/bigredv2/caves/lambda/breakroom)
"bu" = (
/turf/open/floor/almayer/w_y1/north,
/area/bigredv2/caves/lambda/breakroom)
"bv" = (
/turf/open/floor/almayer/w_y2/north,
/area/bigredv2/caves/lambda/breakroom)
"bw" = (
/obj/structure/filingcabinet{
	pixel_x = 7
	},
/obj/structure/filingcabinet{
	density = 0;
	pixel_x = -7;
	pixel_y = 19
	},
/obj/structure/filingcabinet{
	pixel_x = -9
	},
/turf/open/floor/strata/white_cyan1/east,
/area/bigredv2/caves/lambda/breakroom)
"bx" = (
/obj/effect/glowshroom,
/turf/open/mars_cave/mars_cave_5,
/area/bigredv2/caves_lambda)
"by" = (
/obj/structure/filingcabinet{
	density = 0;
	pixel_x = 8;
	pixel_y = 19
	},
/obj/structure/filingcabinet{
	density = 0;
	pixel_x = -9;
	pixel_y = 20
	},
/turf/open/floor/strata/white_cyan1/east,
/area/bigredv2/caves/lambda/breakroom)
"bz" = (
/obj/structure/machinery/light{
	dir = 1
	},
/obj/structure/surface/table/reinforced/prison,
/obj/structure/window/reinforced{
	dir = 8
	},
/obj/structure/window/reinforced{
	dir = 4
	},
/obj/structure/machinery/door/window/brigdoor/southright,
/obj/item/clothing/accessory/medal/gold{
	pixel_x = 7;
	pixel_y = 10
	},
/obj/item/clothing/accessory/medal/bronze/science{
	pixel_x = -5
	},
/turf/open/floor/strata/white_cyan1/east,
/area/bigredv2/caves/lambda/breakroom)
"bA" = (
/obj/structure/filingcabinet{
	density = 0;
	layer = 3.1;
	pixel_x = 8;
	pixel_y = 18
	},
/obj/structure/filingcabinet{
	density = 0;
	pixel_x = -8;
	pixel_y = 20
	},
/turf/open/floor/strata/white_cyan1/east,
/area/bigredv2/caves/lambda/breakroom)

(1,1,1) = {"
aM
aM
aM
aM
aM
bi
bp
bk
bi
aM
aM
aP
bb
aX
"}
(2,1,1) = {"
aM
aM
aM
aM
bx
aG
aw
aD
aG
bc
bc
az
aT
ay
"}
(3,1,1) = {"
aM
aM
ah
bc
bc
aG
ax
aE
aG
aQ
aT
aQ
bc
az
"}
(4,1,1) = {"
aM
al
aQ
aT
az
bi
bq
ao
bi
al
bf
bd
aT
az
"}
(5,1,1) = {"
bc
bc
ai
ak
az
aG
br
bl
aJ
bg
aT
aT
aT
az
"}
(6,1,1) = {"
aP
bc
bc
aT
aT
aG
bs
aD
as
bh
aN
aS
aT
az
"}
(7,1,1) = {"
aT
aT
aX
aX
aX
bi
bt
bm
ap
aM
aM
aQ
aS
az
"}
(8,1,1) = {"
aT
aX
aX
bi
bi
bi
bi
bn
bi
bi
aM
aT
aQ
az
"}
(9,1,1) = {"
az
aX
aX
bi
by
bw
au
au
aK
bi
aM
aP
aT
az
"}
(10,1,1) = {"
aX
aM
aM
bi
au
bo
aB
bo
au
bi
aM
aQ
aT
az
"}
(11,1,1) = {"
aX
aM
aM
bi
bz
bo
bu
bo
bj
bi
aM
aQ
aT
az
"}
(12,1,1) = {"
aM
aM
aM
bi
au
bo
bv
bo
aL
bi
aM
be
aV
aT
"}
(13,1,1) = {"
aM
aM
aM
bi
bA
av
aL
aL
aL
bi
aM
aT
aT
aT
"}
(14,1,1) = {"
aM
aM
aM
bi
bi
bi
bi
bi
bi
bi
aM
aT
aT
aT
"}
